....................
..........---.......
....................
..............---...
....................
.........---........
....................
.........GEG........
....----####........
..........T.........
....GGG.......GGG...
....#-#.......#-#...
....................
.1................X.
####################
