....................
....................
..........X.........
.......######.......
..G..............G..
####..G.G.G.G....###
.......G#G.GCG......
......--------......
...--...........--..
......GGGG.GGGG.....
.G.G...GG..G....G.G.
####...GG..GGGG.####
.......GG..G........
.1....GGGG.GGGG.....
####################
